TTWWWTTWWW
WTTWWTTTWW
WWTWWTWTWW
WWTTTTWTWW
WWWWWWWTWW
WWTTTTTTTT
WWTWTWWWWT
TTTTTWTTTT
WWWWTTTTWW
WWWWWWWTWW